1111111111111111
1000000001000001
10E11000P0101011
1000001100001001
1000C00000001101
1111111111111111