11111111111111111111
10011011100000000001
1PC00011E11000000001
11111111111111111111