11111111111111111111
10001110000000000001
1P001C10E11000000001
10000000000000000001
10000000000000000001
11111111111111111111