11111111111111111111
10001110100000000001
1000000000P000000001
10000000000000000001
11101110111100100101
11101000100100100101
11001110111100100101
11001000100100100101
11001110100010111101
10000000000000C00001
10011110111101111101
10010010100100010001
10010010100100010001
10011110100100010001
10010010100100010001
10010010100100010001
10011110111100010001
10000000000000000001
10000000000C00000001
1000000C000000000111
100000000000000001E1
10000000000000000001
11111111111111111111